11111111111111111111
1E000CI0010001C001C1
1111110010C000000001
10C0C000010000000001
1C0C0C0000C100010CP1
11111111111111111111
